111111111111111
1P1C00001000001
100000001001C01
100111000001111
101C010000000E1
111111111111111