111111111111111
1P1000001000001
100000001001001
100111000001111
1000010000000E1
111111111111111