111111111111111111
1P0000C00000000001
100000001111001C01
100001000000001111
1000010000100000E1
100111000010000001
1C00000000100000N1
111111111111111111