111111111111111
1P1000001000001
100000001001001
100111000001111
100001000N000E1
111111111111111