1111111111111111111111
1P000000001000000000C1
1000000000100000011111
1000001000100N00000001
1000001000000100000001
1C00001000000100C000E1
1111111111111111111111
