111111111111111111
1P0000C00010000001
100000001111001001
10C001000010001111
100001000010000001
100111000010000001
1C0000000E100000N1
111111111111111111